dammi	dare
dammelo	dare
dacci	dare
dammene	dare
mostrami	mostrare
mostramelo	mostrare
mostraci	mostrare
mostramene	mostrare
fammi	fare
fammelo	fare
facci	fare
fammi	fare
scrivimi	scrivere
scrivimelo	scrivere
scrivici	scrivere
scrivimene	scrivere
leggimi	leggere
leggimelo	leggere
leggici	leggere
leggimene	leggere
dimmi	dire
dimmelo	dire
dicci	dire
dimmene	dire
vedimi	vedere
vedimelo	vedere
vederci	vedere
vedimene	vedere
portami	portare
portamelo	portare
portaci	portare
portamene	portare
sentimi	sentire
sentimelo	sentire
sentici	sentire
sentimene	sentire
guardami	guardare
guardamelo	guardare
guardaci	guardare
guardamene	guardare
ascoltami	ascoltare
ascoltamelo	ascoltare
ascoltaci	ascoltare
ascoltamene	ascoltare
parlami	parlare
parlami	parlare
parlagli	parlare
parlamene	parlare
pensami	pensare
pensamici	pensare
pensatelo	pensare
pensamene	pensare
chiedimi	chiedere
chiediglielo	chiedere
chiedilo	chiedere
chiedici	chiedere
chiedimene	chiedere
richiedimi	richiedere
richiedetelo	richiedere
richiediglielo	richiedere
richiedilo	richiedere
richiedimene	richiedere
domandami	domandare
domandatemi	domandare
domandaglielo	domandare
domandalo	domandare
domandamene	domandare
informami	informarsi
informatevi	informarsi
informalo	informarsi
informamene	informarsi
ottienimi	ottenere
ottenetele	ottenere
ottienile	ottenere
ottenimene	ottenere
scoprimi	scoprire
scopritelo	scoprire
scoprilo	scoprire
scoprane	scoprire
indagami	indagare
indagatemi	indagare
indagalo	indagare
indagamene	indagare
esplorami	esplorare
esploratemi	esplorare
esploralo	esplorare
esploramene	esplorare
interrogami	interrogare
interrogatemi	interrogare
interrogalo	interrogare
interrogamene	interrogare
cercami	cercare
cercatemi	cercare
cercalo	cercare
cercamene	cercare
investigami	investigare
investigatemi	investigare
investigalo	investigare
investigamene	investigare
ricercatemi	ricercare
ricercalo	ricercare
ricercamene	ricercare
chiedimi	chiedere
chiedetemene	chiedere
chiedigliene	chiedere
chiediamene	chiedere
verificami	verificare
verificatemi	verificare
verificalo	verificare
verificamene	verificare
conoscimi	conoscere
conoscerti	conoscere
conoscerlo	conoscere
conoscerne	conoscere
informati	informati
informatevi	informati
informalo	informati
informamene	informati